w w w w w w w w w w w w w w w w w
w 0 0 0 0 0 0 0 0 0 0 0 0 0 0 0 w
w p # # # # # # # # # # # # # # w
w 0 # t # 0 # t # 0 # 0 # t # t w
w 0 # 0 # 0 # 0 # 0 # 0 # 0 # 0 w
w 0 # 0 # 0 # 0 # 0 # 0 # 0 # t w
w 0 # 0 # 0 # 0 # 0 # 0 # 0 # 0 w
w 0 # 0 # 0 # 0 # 0 # 0 # 0 # t w
w 0 # 0 # 0 # 0 # 0 # 0 # 0 # 0 w
w 0 # t # e # t # e # t # e # t w
w 0 # 0 # 0 # 0 # 0 # 0 # 0 # 0 w
w 0 # 0 # 0 # 0 # 0 # 0 # 0 # t w
w 0 # 0 # 0 # 0 # 0 # 0 # 0 # 0 w
w 0 # 0 # 0 # 0 # 0 # 0 # 0 # t w
w 0 # 0 # 0 # 0 # 0 # 0 # 0 # 0 w
w 0 # 0 # 0 # 0 # 0 # 0 # 0 # t w
w 0 # e # t # e # t # e # 0 # 0 w
w 0 # # # # # # # # # # # # # # w
w w w w w w w w w w w w w w w w w
