w w w w w w w w w w 
w 0 0 0 0 0 0 0 0 w
w 0 t t t t t t 0 w
w 0 t 0 0 0 0 t 0 w
w p t 0 t e 0 t 0 w
w 0 t 0 t e 0 t 0 w
w 0 t 0 0 0 0 t 0 w
w 0 t t t t t t 0 w
w 0 0 0 0 0 0 0 0 w
w w w w w w w w w w
