w w w w w w w w w w w w w w w w w w w w w w w w w w w w w w w w w w w w w w w w w w w w w
w p t 0 0 t 0 0 t 0 0 t 0 0 t 0 0 t 0 0 t 0 0 t 0 0 t 0 0 t 0 0 t 0 0 t 0 0 t 0 0 t 0 0 w
w 0 t 0 t 0 0 t 0 0 t 0 0 t 0 0 t 0 0 t 0 0 t 0 0 t 0 0 t 0 0 t 0 0 t 0 0 t 0 0 t 0 t 0 w
w 0 t 0 0 t 0 0 t 0 0 t 0 0 t 0 0 t 0 0 t 0 0 t 0 0 t 0 0 t 0 0 t 0 0 t 0 0 t 0 0 t 0 0 w
w 0 t 0 0 t 0 0 t 0 0 t 0 0 t 0 0 t 0 0 t 0 0 t 0 0 t 0 0 t 0 0 t 0 0 t 0 0 t 0 0 t 0 0 w
w 0 t 0 0 t 0 0 t 0 0 t 0 0 t 0 0 t 0 0 t 0 0 t 0 0 t 0 0 t 0 0 t 0 0 t 0 0 t 0 0 t 0 0 w
w 0 t 0 0 t 0 0 t 0 0 t 0 0 t 0 0 t 0 0 t 0 0 t 0 0 t 0 0 t 0 0 t 0 0 t 0 0 t 0 0 t 0 0 w
w 0 t 0 0 t 0 0 t 0 0 t 0 0 t 0 0 t 0 0 t 0 0 t 0 0 t 0 0 t 0 0 t 0 0 t 0 0 t 0 0 t 0 0 w
w 0 t 0 0 t 0 0 t 0 0 t 0 0 t 0 0 t 0 0 t 0 0 t 0 0 t 0 0 t 0 0 t 0 0 t 0 0 t 0 0 t 0 0 w
w 0 t 0 0 t 0 0 t 0 0 t 0 0 t 0 0 t 0 0 t 0 0 t 0 0 t 0 0 t 0 0 t 0 0 t 0 0 t 0 0 t 0 0 w
w 0 t 0 0 t 0 0 t 0 0 t 0 0 t 0 0 t 0 0 t 0 0 t 0 0 t 0 0 t 0 0 t 0 0 t 0 0 t 0 0 t 0 0 w
w 0 t 0 0 t 0 0 t 0 0 t 0 0 t 0 0 t 0 0 t 0 0 t 0 0 t 0 0 t 0 0 t 0 0 t 0 0 t 0 0 t 0 0 w
w 0 t 0 0 t 0 0 t 0 0 t 0 0 t 0 0 t 0 0 t 0 0 t 0 0 t 0 0 t 0 0 t 0 0 t 0 0 t 0 0 t 0 0 w
w 0 t 0 0 t 0 0 t 0 0 t 0 0 t 0 0 t 0 0 t 0 0 t 0 0 t 0 0 t 0 0 t 0 0 t 0 0 t 0 0 t 0 0 w
w 0 t 0 0 t 0 0 t 0 0 t 0 0 t 0 0 t 0 0 t 0 e t 0 0 t 0 0 t 0 0 t 0 0 t 0 0 t 0 0 t 0 0 w
w 0 t 0 0 t 0 0 t 0 0 t 0 0 t 0 0 t 0 0 t 0 0 t 0 0 t 0 0 t 0 0 t 0 0 t 0 0 t 0 0 t 0 0 w
w 0 t 0 0 t 0 0 t 0 0 t 0 0 t 0 0 t 0 0 t 0 0 t 0 0 t 0 0 t 0 0 t 0 0 t 0 0 t 0 0 t 0 0 w
w 0 t 0 t 0 0 t 0 0 t 0 0 t 0 0 t 0 0 t 0 t 0 t 0 0 t 0 0 t 0 0 t 0 0 t 0 0 t 0 0 t 0 0 w
w 0 t 0 0 t 0 0 t 0 0 t 0 0 t 0 0 t 0 0 t 0 0 t 0 0 t 0 0 t 0 0 t 0 0 t 0 0 t 0 0 t 0 0 w
w 0 t 0 0 t 0 0 t 0 0 t 0 0 t 0 0 t 0 0 t 0 0 t 0 0 t 0 0 t 0 0 t 0 0 t 0 0 t 0 0 t 0 0 w
w 0 t 0 0 t 0 0 t 0 0 t 0 0 t 0 0 t 0 0 t 0 0 t 0 0 t 0 0 t 0 0 t 0 0 t 0 0 t 0 0 t 0 0 w
w 0 t 0 0 t 0 0 t 0 0 t 0 0 t 0 0 t 0 0 t 0 0 t 0 0 t 0 0 t 0 0 t 0 0 t 0 0 t 0 0 t 0 0 w
w 0 t 0 0 t 0 0 t 0 0 t 0 0 t 0 0 t 0 0 t 0 0 t 0 0 t 0 0 t 0 0 t 0 0 t 0 0 t 0 0 t 0 0 w
w 0 t 0 0 t 0 0 t 0 0 t 0 0 t 0 0 t 0 0 t 0 0 t 0 0 t 0 0 t 0 0 t 0 0 t 0 0 t 0 0 t 0 0 w
w 0 t 0 0 t 0 0 t 0 0 t 0 0 t 0 0 t 0 0 t 0 0 t 0 0 t 0 0 t 0 0 t 0 0 t 0 0 t 0 0 t 0 0 w
w 0 t 0 0 t 0 0 t 0 0 t 0 0 t 0 0 t 0 0 t 0 0 t 0 0 t 0 0 t 0 0 t 0 0 t 0 0 t 0 0 t 0 0 w
w 0 t 0 0 t 0 0 t 0 0 t 0 0 t 0 0 t 0 0 t 0 0 t 0 0 t 0 0 t 0 0 t 0 0 t 0 0 t 0 0 t 0 0 w
w 0 t 0 0 t 0 0 t 0 0 t 0 0 t 0 0 t 0 0 t 0 0 t 0 0 t 0 0 t 0 0 t 0 0 t 0 0 t 0 0 t 0 0 w
w 0 t 0 0 t 0 0 t 0 0 t 0 0 t 0 0 t 0 0 t 0 0 t 0 0 t 0 0 t 0 0 t 0 0 t 0 0 t 0 0 t 0 0 w
w 0 t 0 0 t 0 0 t 0 0 t 0 0 t 0 0 t 0 0 t 0 0 t 0 0 t 0 0 t 0 0 t 0 0 t 0 0 t 0 0 t 0 0 w
w 0 t 0 0 t 0 0 t 0 0 t 0 0 t 0 0 t 0 0 t 0 0 t 0 0 t 0 0 t 0 0 t 0 0 t 0 0 t 0 0 t 0 0 w
w 0 t 0 0 t 0 0 t 0 0 t 0 0 t 0 0 t 0 0 t 0 0 t 0 0 t 0 0 t 0 0 t 0 0 t 0 0 t 0 0 t 0 0 w
w 0 w w w 0 w 0 t 0 0 t 0 0 t 0 0 t 0 0 t 0 0 t 0 0 t 0 0 t 0 0 t 0 0 t 0 0 w 0 w w w 0 w
w 0 t 0 w 0 t 0 0 t 0 0 t 0 0 t 0 0 t 0 0 t 0 0 t 0 0 t 0 0 t 0 0 t 0 0 t 0 0 0 w 0 t 0 w
w 0 t 0 w w w 0 t 0 0 t 0 0 t 0 0 t 0 0 t 0 0 t 0 0 t 0 0 t 0 0 t 0 0 t 0 0 w w w 0 t 0 w
w 0 t 0 0 t 0 0 t 0 0 t 0 0 t 0 0 t 0 0 t 0 0 t 0 0 t 0 0 t 0 0 t 0 0 t 0 0 t 0 0 t 0 0 w
w 0 w w w w w w w w w w w w w w w w w w w w w w w w w w w w w w w w w w w w w w w w w 0 w
w 0 t 0 t 0 0 t 0 0 t 0 0 t 0 0 t 0 0 t 0 0 t 0 0 t 0 0 t 0 0 t 0 0 t 0 0 t 0 0 t 0 t 0 w
w 0 t 0 0 t 0 0 t 0 0 t 0 0 t 0 0 t 0 0 t 0 0 t 0 0 t 0 0 t 0 0 t 0 0 t 0 0 t 0 0 t 0 0 w
w w w w w w w w w w w w w w w w w w w w w w w w w w w w w w w w w w w w w w w w w w w w w