w w w w w w w w w w w w w w w w w w w w w
w 0 0 0 0 0 0 0 0 0 0 0 0 0 0 0 0 0 0 0 w
w 0 w w w w w w w w w w w w w w w w w 0 w
w p w 0 0 0 0 0 0 0 w 0 0 0 0 0 0 w w 0 w
w 0 w e t 0 0 0 0 0 w 0 0 0 0 t 0 w w 0 w
w 0 w 0 0 0 0 0 0 0 w 0 0 0 0 0 0 w w 0 w
w 0 w 0 t 0 0 0 0 0 w 0 0 0 0 0 0 w w 0 w
w 0 w 0 0 0 0 w w w w w w 0 0 0 0 w t 0 w
w 0 w 0 0 0 0 w t t t t w 0 0 0 0 0 w 0 w
w 0 w 0 0 0 0 0 t t t t w e 0 0 0 0 w 0 w
w 0 w 0 0 0 0 w t t t t 0 0 0 0 0 0 w 0 w
w 0 w 0 0 0 0 w t t t t w 0 0 0 0 0 w 0 w
w 0 w 0 0 0 0 w w w w w w 0 0 0 0 0 w 0 w
w 0 w 0 t 0 0 0 0 0 w 0 0 0 0 0 0 0 w 0 w
w 0 w 0 0 0 0 0 0 0 w 0 0 0 0 0 0 0 w 0 w
w 0 w 0 0 0 0 0 0 0 w 0 0 0 0 0 0 0 w 0 w
w 0 w 0 t 0 0 0 0 0 w 0 0 0 0 t 0 0 w 0 w
w 0 w 0 0 0 0 0 0 0 w 0 0 0 0 0 0 0 w 0 w
w 0 w t t t t t t t w t t t t t t t t 0 w
w 0 w w w w w w w w t w w w w w w w 0 0 w
w 0 t 0 0 0 0 0 0 0 t 0 0 0 0 0 0 0 0 0 w
w 0 t 0 0 0 0 0 0 0 w 0 0 0 0 0 0 0 0 0 w
w w w w w w w w w w w w w w w w w w w w w
