w w w w w w w w w w w w w w w w w
w 0 0 0 0 0 0 0 0 0 0 0 0 0 0 0 w
w e 0 0 0 t 0 0 0 0 0 0 w 0 0 0 w
w 0 0 0 0 0 0 0 0 0 0 0 w t 0 0 w
w 0 w w w w w w w w 0 w w w w 0 w
w 0 0 0 0 0 0 0 0 0 0 0 0 0 0 0 w
w 0 w w w w w w w w 0 w w w w w w
w e 0 0 0 0 0 0 0 0 0 w 0 e 0 0 w
w w 0 w w w w w w w 0 w 0 w 0 w w
w t 0 w 0 0 w 0 0 0 0 w 0 0 w 0 w
w 0 w w 0 0 0 0 0 0 0 w 0 0 w 0 w
w 0 0 0 0 w w w w 0 w w w w w 0 w
w t w w w 0 0 0 0 0 0 0 0 0 0 0 w
w w w w w 0 w 0 0 0 0 0 w 0 w w w
w 0 0 0 0 0 0 0 0 0 0 0 w 0 0 0 w
w p w w w w w w w w w w w w w 0 w
w 0 0 0 0 0 0 0 t 0 0 0 0 0 0 0 w
w w w w w w w w w w w w w w w w w
