w w w w w w w w w 
w 0 0 0 0 a 0 2 w
w p 0 0 0 w w w w
w 0 0 0 0 b 0 3 w
w 0 0 0 0 w w w w
w 0 0 0 0 c 0 4 w
w 0 0 0 0 w w w w
w 0 0 0 0 d 1 t w
w 0 0 0 0 w w w w
w 0 0 0 0 d 0 4 w
w 0 0 0 0 w w w w
w 0 0 0 0 a 0 t w
w 0 0 0 0 w w w w
w 0 0 0 0 w w w w
w 0 0 0 0 0 0 1 w
w w w w w w w w w
