w w w w w w w w w w
w 0 0 0 0 0 0 0 0 w
w 0 w w 0 w w 0 0 w
w p 0 0 0 e 0 w 0 w
w 0 w w w 0 w w 0 w
w 0 w w w 0 w w w w
w 0 w t w 0 0 0 0 w
w 0 w 0 w w w w 0 w
w 0 0 0 w 0 0 0 0 w
w w w w w w w w w w
